XXXXXXXXXXXXXXX
XOOOOOOOOXOOOSX
XOOOOOOOOXOOOOX
XOXXXXXOOXOOOOX
XOOOOOOOOOOOOOX
XOOOPOOOOOOOOOX
XXXXXXXOOXXXXXX
XOOOOOOOOOOOOSX
XXXXXXXOOXXXXXX
XOOOOOOOOOOOOOX
XOOOOOXOXOOOOOX
XOOOOOXOXOOOOOX
XOOOOOXOXOOOOOX
XGOOOOOOOOOOOGX
XXXXXXXXXXXXXXX

