XXXXXXXXXXXXXXX
XOOOGOOOOXOOOOX
XOOOOOOOOXOOOOX
XOOOOOOOOXOOGOX
XOOOOOOOOXOOOOX
XOOOXOOOOOOOOOX
XOOOXXXOXXXOGOX
XOOOOOOOOOOOOOX
XOOOXXXOXXXOOOX
XOOOOOOOOOOOOOX
XOOOGOOOXOOOOOX
XOOOOOOOXOOPOOX
XOOOOOOOXOOOOOX
XOOOOOOOOOOOOOX
XXXXXXXXXXXXXXX
