XXXXXXXXXXXXXXX
XOOOOOOOOXOOOOX
XOOOOOOOOXOOGOX
XOOOOGOOOXOOOOX
XOOOOOOOOXOOOOX
XOOOXOOOOOOOOOX
XOOOXXXOXXXOOOX
XOOOOOOOOOOOOOX
XOGOXXXOXXXOOOX
XOOOOOOOOOOOOOX
XOOOOOOOXOOOOOX
XOOGOOOOXOOPOOX
XOOOOOOOXOOOOOX
XOOOOOOOOOOOOOX
XXXXXXXXXXXXXXX
